####################
#P                 #
#                  #
#     #            #
#     #            #
#    #             #
#   # M            #
#  #               #
#                 G#
####################