##########
#P       #
#        #
#     #  #
#     #  #
#    #   #
#   # M  #
#  #     #
#       G#
##########